{
  "version": 0,
  "title": "DCODE.fr Maze",
  "start": [0, 1, 0],
  "finish": [3, 1, 4],
	"numberOfTransforms": [1, 2, 3],
  "ground":[
    [1, 1, 0, 0, 0, 0, 0, 0, 0, 0, 0], 
    [1, 1, 1, 1, 0, 1, 0, 1, 1, 1, 0], 
    [0, 1, 0, 1, 0, 1, 0, 1, 0, 0, 0], 
    [0, 1, 0, 1, 1, 1, 1, 1, 1, 1, 0], 
    [0, 1, 0, 0, 0, 0, 0, 0, 0, 1, 0], 
    [0, 1, 0, 1, 1, 1, 0, 1, 1, 1, 0], 
    [0, 1, 0, 1, 0, 0, 0, 1, 0, 1, 0], 
    [0, 1, 0, 1, 0, 1, 1, 1, 0, 1, 0], 
    [0, 1, 0, 1, 0, 0, 0, 1, 0, 0, 0]
  ],
  "lilypads": [],
  "lilypadPaths": [],
  "objects": []
}
